11 11 11 11 11 11 11 11 11 51 11 51 11 11 11 11 11 11 11 11 11 11 11 11 11 11 11 11 11 11 11 11 11 11 11 11 11 11 11 11 11 11 11 11 11 11 11 11 11 11 
11 11 11 11 11 11 11 11 11 11 11 51 11 11 11 11 11 11 11 11 11 11 11 11 11 11 11 11 11 11 11 11 11 11 11 11 11 11 11 11 11 11 11 11 11 11 11 51 51 11 
11 11 11 11 11 11 11 11 11 11 11 11 11 11 11 11 11 51 11 11 11 11 11 51 11 11 11 11 51 11 11 11 11 11 11 11 11 51 11 11 11 11 11 11 51 11 11 11 11 11 
11 11 11 11 11 11 51 11 11 11 11 11 51 11 51 11 11 11 11 11 11 11 11 11 51 11 11 11 11 51 11 11 11 11 11 11 11 11 11 11 11 11 11 11 11 51 11 11 11 11 
11 11 11 11 11 11 11 51 11 51 11 11 11 11 11 11 11 51 11 11 11 51 11 11 11 11 11 11 11 11 11 11 11 11 11 11 11 11 11 51 11 11 11 11 11 11 11 11 11 11 
11 11 11 11 11 11 11 11 11 11 11 11 11 11 11 11 11 11 11 51 51 11 11 11 11 51 11 11 11 11 11 11 11 11 11 11 11 11 11 11 11 11 11 11 11 11 11 11 51 11 
11 11 11 11 11 51 51 11 11 11 11 11 11 11 11 11 11 11 51 11 11 11 11 11 11 11 11 11 51 51 11 11 11 11 11 11 11 11 51 51 11 11 11 11 11 11 11 11 11 11
11 11 11 11 11 11 11 11 11 11 20 12 12 12 12 12 12 12 12 12 12 12 12 12 22 11 11 11 11 11 11 11 51 20 12 12 12 12 12 12 12 12 22 11 11 11 11 11 11 11
11 11 11 11 11 11 11 11 11 11 16 10 10 10 10 10 10 10 10 10 10 10 10 10 15 11 11 11 11 11 11 51 11 16 10 10 10 10 10 10 10 10 15 11 11 11 51 11 11 11 
11 11 11 11 11 11 11 11 11 11 16 10 10 10 10 10 10 10 10 10 10 10 10 10 15 11 11 11 11 11 11 11 11 16 10 10 10 10 10 10 10 10 15 11 11 11 11 11 11 11 
11 11 11 11 11 11 51 11 11 11 16 10 10 10 10 10 10 10 10 10 10 10 10 10 13 12 12 12 12 12 12 12 12 14 10 10 10 10 10 10 10 10 15 11 11 11 11 11 11 11
11 11 11 11 11 11 11 11 11 11 16 10 10 10 10 38 38 38 38 38 46 42 10 10 10 10 10 10 10 10 10 10 10 10 40 40 10 10 10 10 10 10 15 11 51 11 11 11 11 11 
11 11 11 11 11 11 11 51 51 11 16 10 10 10 10 38 39 39 39 38 46 42 10 10 10 10 10 10 10 10 10 10 10 10 40 40 10 10 10 10 10 10 15 11 11 11 11 11 11 11 
11 11 11 11 11 11 11 11 11 11 16 10 10 10 10 38 39 39 39 38 47 47 26 26 36 40 40 10 18 17 17 17 19 10 40 40 29 25 28 10 10 10 15 11 11 11 11 51 11 11 
11 11 11 11 51 51 11 11 11 11 16 10 10 10 10 38 39 39 39 39 25 25 25 25 28 40 40 10 15 11 11 11 16 10 40 40 29 25 28 10 10 10 15 11 11 11 11 11 11 11 
11 11 11 11 11 11 11 11 11 11 16 10 10 10 10 38 39 39 39 38 45 45 33 25 28 40 40 10 15 11 11 11 16 10 10 10 29 25 28 10 10 10 15 11 11 11 11 11 11 11 
11 11 11 11 11 11 11 11 11 11 16 10 10 10 10 38 39 39 39 38 46 42 29 25 28 10 10 10 15 11 11 11 16 10 40 40 29 25 28 10 10 10 15 11 11 51 11 11 11 11 
11 11 11 11 11 11 11 11 11 11 16 10 10 10 10 38 38 38 38 38 46 42 29 25 28 40 40 10 13 12 12 12 14 10 40 40 29 25 28 10 10 10 15 11 11 11 11 11 11 11 
11 11 11 11 11 11 11 51 11 11 16 10 10 10 10 10 10 10 10 10 10 10 29 25 28 40 40 10 10 10 10 10 10 10 40 40 29 25 28 10 10 10 15 11 11 11 11 11 11 11
11 11 11 11 11 11 11 11 11 11 16 10 10 10 10 10 10 10 10 10 10 37 31 25 30 36 40 40 40 40 10 40 40 40 40 40 29 25 28 10 10 10 15 11 11 11 11 11 11 11 
11 11 11 11 11 11 11 11 11 11 16 10 10 26 26 26 26 26 26 26 26 31 25 25 25 30 26 26 26 26 26 26 26 26 26 26 31 25 28 10 10 10 15 11 11 11 11 11 11 11
11 11 11 11 51 11 11 11 11 11 16 10 10 25 25 25 25 25 25 25 25 25 25 25 25 25 25 25 25 25 25 25 25 25 25 25 25 25 28 10 10 10 15 51 11 51 11 11 11 11
11 11 11 11 11 11 11 11 11 51 16 10 42 45 45 44 25 49 45 45 45 44 25 25 25 32 27 27 27 27 27 27 27 27 27 27 27 27 35 10 10 10 15 11 11 11 11 11 11 11 
11 11 11 11 51 51 11 11 11 11 16 42 42 42 42 43 25 48 46 46 46 50 44 25 32 35 40 40 40 40 40 40 40 42 10 10 10 10 10 10 10 10 15 11 11 11 11 11 51 51 
11 11 11 11 11 11 11 11 11 11 16 42 42 42 42 43 25 48 46 46 46 46 43 25 28 40 40 40 40 40 40 40 40 46 40 40 40 40 40 40 40 40 15 11 11 11 11 11 11 11 
51 51 51 11 11 11 11 11 11 11 16 42 42 42 42 43 25 48 46 46 46 46 43 25 28 40 40 40 40 40 40 40 46 46 42 10 41 41 41 41 40 40 15 11 51 11 11 11 11 11 
11 11 11 11 11 11 51 11 11 11 16 10 42 42 42 43 25 48 42 42 42 42 29 25 28 40 40 40 40 40 40 40 40 46 42 10 41 10 40 10 40 40 15 11 11 11 11 11 11 11 
11 11 11 11 11 11 11 11 11 11 16 10 10 10 42 43 25 48 42 42 42 10 29 25 28 40 40 40 40 40 40 40 40 40 10 10 10 42 40 41 40 40 15 11 11 11 11 51 11 11 
11 11 11 11 11 11 11 11 11 51 16 10 10 10 10 29 25 28 10 10 10 10 29 25 28 10 42 41 41 41 41 41 41 40 41 41 10 41 40 42 40 40 15 11 11 11 11 11 11 11
11 11 11 11 51 51 11 11 11 11 16 10 10 10 10 29 25 28 41 10 10 10 29 25 28 40 40 40 40 40 40 10 41 40 40 40 40 40 40 41 40 40 15 11 11 51 11 11 11 11 
11 11 11 11 11 11 11 11 11 11 16 10 10 10 10 29 25 28 10 10 10 41 29 25 28 40 40 40 10 10 40 40 41 10 10 41 41 41 42 41 40 40 15 11 11 11 11 11 11 11
11 11 11 11 11 11 11 20 12 12 14 10 10 10 10 29 25 28 10 41 41 10 29 25 28 40 40 40 40 10 40 40 40 40 40 40 40 40 40 40 40 40 15 51 11 11 11 11 51 11 
11 11 51 11 11 11 11 16 10 10 10 10 10 10 10 29 25 28 10 10 10 10 29 25 28 40 40 40 40 10 40 40 40 40 40 40 40 40 10 10 10 10 15 11 11 11 11 11 11 11 
11 11 11 11 11 11 11 16 10 10 10 10 10 10 10 29 25 28 10 10 10 10 29 25 30 26 26 26 26 26 26 26 26 26 26 10 10 10 10 10 10 10 15 11 11 51 11 11 11 11 
11 11 11 11 11 51 11 16 10 10 10 10 10 10 10 29 25 28 10 10 10 10 29 25 25 25 25 25 25 25 25 25 25 25 25 10 10 10 10 10 10 10 15 11 11 11 11 11 11 11 
11 11 11 11 51 11 11 16 10 10 10 10 10 10 10 29 25 28 10 10 10 10 34 27 27 27 27 27 27 27 27 27 27 27 27 10 10 10 10 10 10 10 15 11 11 11 11 11 11 11 
11 11 11 11 11 11 11 16 10 10 10 10 10 26 26 31 25 28 10 10 10 10 10 10 10 10 10 10 10 10 10 10 10 10 10 10 10 10 10 10 10 10 15 11 11 11 11 11 11 11 
11 11 51 11 11 11 11 16 10 10 10 10 10 25 25 25 25 28 10 10 10 10 10 10 10 10 10 10 10 10 10 10 10 10 10 10 10 10 10 10 10 10 15 51 51 11 11 11 11 11 
11 11 11 11 11 11 11 16 10 10 10 10 10 27 27 27 27 35 10 10 10 10 10 10 10 10 10 10 10 10 10 10 10 10 10 10 10 10 10 10 10 10 15 11 11 11 11 11 11 11
11 11 11 11 11 11 11 16 10 10 10 10 10 10 10 10 10 10 10 10 10 10 18 17 17 17 17 17 17 17 19 10 10 10 10 10 10 10 10 10 10 10 15 11 11 11 11 11 11 11 
11 11 11 11 51 11 11 16 10 10 10 10 10 10 10 10 10 10 10 10 10 10 15 11 11 11 11 11 51 51 16 10 10 10 10 10 10 10 10 10 10 10 15 11 11 51 51 11 11 11
11 11 11 11 11 11 11 16 10 10 10 10 10 10 10 10 10 10 10 10 10 10 15 11 11 11 11 11 11 11 16 10 10 10 10 10 10 10 10 10 10 10 15 11 11 11 11 11 11 11
11 11 11 11 11 11 11 23 17 17 17 17 17 17 17 17 17 17 17 17 17 17 24 11 11 11 11 11 11 11 16 10 10 10 10 10 10 10 10 10 10 18 24 11 11 11 11 11 11 11 
11 11 11 11 51 11 11 11 11 11 11 11 51 11 51 11 11 11 11 11 11 11 11 11 11 11 11 11 11 11 23 17 17 17 17 17 17 17 17 17 17 24 11 11 11 11 11 11 11 11 
11 11 11 11 11 11 11 11 11 11 11 11 11 11 11 11 11 11 11 11 11 11 11 11 11 51 11 11 11 51 11 11 11 11 11 11 11 11 11 11 11 51 11 11 51 11 11 11 11 11 
11 51 11 11 11 11 11 11 11 11 11 11 11 11 11 11 11 11 11 11 11 11 11 51 11 11 11 11 11 11 11 11 11 11 11 11 51 11 11 11 11 11 11 11 11 11 11 11 11 11 
11 11 11 11 11 11 11 11 11 11 11 11 11 11 11 11 11 51 11 11 11 11 51 11 11 11 11 11 11 11 11 51 11 11 11 11 11 11 51 11 11 11 11 11 11 11 11 11 11 11 
11 11 51 11 11 11 11 11 11 11 51 11 11 11 11 51 11 11 11 11 11 11 11 11 11 11 11 11 11 11 11 11 11 11 11 11 11 11 11 11 11 11 11 11 11 11 11 11 11 11 
11 11 11 11 11 11 11 11 11 11 11 11 11 11 11 11 11 11 11 11 11 11 11 11 11 11 11 11 11 11 11 51 11 11 11 51 11 11 11 11 11 51 11 11 11 51 11 11 11 11 
11 11 11 11 11 11 11 11 11 11 11 11 11 11 11 11 11 11 11 11 11 11 11 11 11 11 11 11 11 11 11 11 11 11 11 11 11 11 11 11 11 11 11 11 11 11 11 11 11 11 